GGGGGGGGGGGGGGGGGG
GGGGGGGGGGGGGGGGGG
GGGGGGGGGGGGGGGGGG
GGGGGGGGGGGGGGGGGG
GGGGGGGGGGGGGGGGGG
GGGGGGGGGGGGGGGGGG
SSSSSGGGGSSSSGSSSS
SSSSSSSGSSSSSSSSSS
SSSWWWSSSSWWWWSSWS
WWWWWWWWSWWWWWWSWW
WWWWWWWWWWWWWWWWWW
WWWWWWWWWWWWWWWWWW
WWWWWWWWWWWWWWWWWW
WWWWWWWWWWWWSSWWWW
WWSSWWWWWWSSSSSSWW
SSSSSSSSSSGSSSSSSS
GGGSSSSSSGGGSSSSGG
GGGGGGGGGGGGGGGGGG